1111111111111
1000000000011
10000P0011111
1000000000011
1111100000011
100C000000011
1000110C00011
1000000000011
11100C0000011
1111111011111
1E00000000011
1111111111111